F---------7
|F-------7|
||F-----7||
|||F---7|||
||||F-7||||
|||||sJ||||
||||L--J|||
|||L----J||
||L------J|
|L--------J
L--------g 