s  F77777
|77|7777|
7777 777L
 777-777 
77777-777
L---7 77|
 77777777
77777777 
L-------g