F-------------------------------------------------7
|F-----------------------------------------------7|
||F---------------------------------------------7||
|||F-------------------------------------------7|||
||||F-----------------------------------------7||||
|||||F---------------------------------------7|||||
||||||F-------------------------------------7||||||
|||||||F-----------------------------------7|||||||
||||||||F---------------------------------7||||||||
|||||||||F-------------------------------7|||||||||
||||||||||F-----------------------------7||||||||||
|||||||||||F---------------------------7|||||||||||
||||||||||||F-------------------------7||||||||||||
|||||||||||||F-----------------------7|||||||||||||
||||||||||||||F---------------------7||||||||||||||
|||||||||||||||F-------------------7|||||||||||||||
||||||||||||||||F-----------------7||||||||||||||||
|||||||||||||||||F---------------7|||||||||||||||||
||||||||||||||||||F-------------7||||||||||||||||||
|||||||||||||||||||F-----------7|||||||||||||||||||
||||||||||||||||||||F---------7||||||||||||||||||||
|||||||||||||||||||||F-------7|||||||||||||||||||||
||||||||||||||||||||||F-----7||||||||||||||||||||||
|||||||||||||||||||||||F---7|||||||||||||||||||||||
||||||||||||||||||||||||F-7||||||||||||||||||||||||
|||||||||||||||||||||||||s|||||||||||||||||||||||||
|||||||||||||||||||||||||LJ||||||||||||||||||||||||
||||||||||||||||||||||||L--J|||||||||||||||||||||||
|||||||||||||||||||||||L----J||||||||||||||||||||||
||||||||||||||||||||||L------J|||||||||||||||||||||
|||||||||||||||||||||L--------J||||||||||||||||||||
||||||||||||||||||||L----------J|||||||||||||||||||
|||||||||||||||||||L------------J||||||||||||||||||
||||||||||||||||||L--------------J|||||||||||||||||
|||||||||||||||||L----------------J||||||||||||||||
||||||||||||||||L------------------J|||||||||||||||
|||||||||||||||L--------------------J||||||||||||||
||||||||||||||L----------------------J|||||||||||||
|||||||||||||L------------------------J||||||||||||
||||||||||||L--------------------------J|||||||||||
|||||||||||L----------------------------J||||||||||
||||||||||L------------------------------J|||||||||
|||||||||L--------------------------------J||||||||
||||||||L----------------------------------J|||||||
|||||||L------------------------------------J||||||
||||||L--------------------------------------J|||||
|||||L----------------------------------------J||||
||||L------------------------------------------J|||
|||L--------------------------------------------J||
||L----------------------------------------------J|
|L------------------------------------------------J
L------------------------------------------------g 