s||||||||||||||||||||||||||||F
7||||||||||||||||||||||||||||F
7||||||||||||||||||||||||||||F
7||||||||||||||||||||||||||||F
7||||||||||||||||||||||||||||F
7||||||||||||||||||||||||||||F
7||||||||||||||||||||||||||||F
7||||||||||||||||||||||||||||F
7||||||||||||||||||||||||||||F
7||||||||||||||||||||||||||||F
7||||||||||||||||||||||||||||F
7||||||||||||||||||||||||||||F
7||||||||||||||||||||||||||||F
7||||||||||||||||||||||||||||F
7||||||||||||||||||||||||||||F
7||||||||||||||||||||||||||||F
7||||||||||||||||||||||||||||F
7||||||||||||||||||||||||||||F
7||||||||||||||||||||||||||||F
7||||||||||||||||||||||||||||F
7||||||||||||||||||||||||||||F
7||||||||||||||||||||||||||||F
7||||||||||||||||||||||||||||F
7||||||||||||||||||||||||||||F
7||||||||||||||||||||||||||||F
7||||||||||||||||||||||||||||F
7||||||||||||||||||||||||||||F
7||||||||||||||||||||||||||||F
7||||||||||||||||||||||||||||F
7||||||||||||||||||||||||||||g